[console_scripts]
wgc-angular-separation = webgeocalc.cli:cli_angular_separation
wgc-angular-size = webgeocalc.cli:cli_angular_size
wgc-bodies = webgeocalc.cli:cli_bodies
wgc-calculation = webgeocalc.cli:cli_calculation
wgc-frame-transformation = webgeocalc.cli:cli_frame_transformation
wgc-frames = webgeocalc.cli:cli_frames
wgc-gf-angular-separation-search = webgeocalc.cli:cli_gf_angular_separation_search
wgc-gf-coordinate-search = webgeocalc.cli:cli_gf_coordinate_search
wgc-gf-distance-search = webgeocalc.cli:cli_gf_distance_search
wgc-gf-illumination-angles-search = webgeocalc.cli:cli_gf_illumination_angles_search
wgc-gf-occultation-search = webgeocalc.cli:cli_gf_occultation_search
wgc-gf-phase-angle-search = webgeocalc.cli:cli_gf_phase_angle_search
wgc-gf-range-rate-search = webgeocalc.cli:cli_gf_range_rate_search
wgc-gf-ray-in-fov-search = webgeocalc.cli:cli_gf_ray_in_fov_search
wgc-gf-sub-point-search = webgeocalc.cli:cli_gf_sub_point_search
wgc-gf-surface-intercept-point-search = webgeocalc.cli:cli_gf_surface_intercept_point_search
wgc-gf-target-in-instrument-fov-search = webgeocalc.cli:cli_gf_target_in_instrument_fov_search
wgc-illumination-angles = webgeocalc.cli:cli_illumination_angles
wgc-instruments = webgeocalc.cli:cli_instruments
wgc-kernels = webgeocalc.cli:cli_kernel_sets
wgc-osculating-elements = webgeocalc.cli:cli_osculating_elements
wgc-phase-angle = webgeocalc.cli:cli_phase_angle
wgc-pointing-direction = webgeocalc.cli:cli_pointing_direction
wgc-state-vector = webgeocalc.cli:cli_state_vector
wgc-subobserver-point = webgeocalc.cli:cli_subobserver_point
wgc-subsolar-point = webgeocalc.cli:cli_subsolar_point
wgc-surface-intercept-point = webgeocalc.cli:cli_surface_intercept_point
wgc-tangent-point = webgeocalc.cli:cli_tangent_point
wgc-time-conversion = webgeocalc.cli:cli_time_conversion
